%%%%%%%%%%%%%%%%%%%%%%%%%%%%%%%%%%%%%%
%.%     % %   % %   %               %%
%...%% %%  % %  % %  % % % %% % %% %%%
% %.% %   %   %   % %     %   %     %%
%  .    %% % %%%%   %% % %%% %  %% %%%
% %.% % %         %           %   % %%
% %.     % % %% %%%% %% % %% % % %  %%
%  .% % %         %       %       % %%
%%%.%% % % % % %%%  % % %%  %% % % %%%
%  .....      %   % % %   % % %     %%
% %% %%.%%% %   %       %%      %% %%%
%      .      %   % % %   % % % %   %%
% %%% %.%%%% % % %% % % %%%%    % % %%
%   %  .%   %   %       % % % % %   %%
%% % %%.  % % %   % %% %% %%  %  % %%%
% %   %.%       %   %       %   %   %%
% % % %.  %% %% %%%%  % % %%% %   % %%
%      .%         % %     % %   %   %%
%% % %%. % %% % %  % % %%    %%% % %%%
%   %  .........  % % % % % %       %%
% %  % % %% % %.% %         %% %%% %%%
%   % %   %    .  % % % % % %   %   %%
% %%  %%%  % %%.%%    % %% %  %% %% %%
%   %   % %   %...% %       %   %   %%
%% % % %% %% % %%.....% %% % %%  % %%%
% %   %           % %.... %     %   %%
%   %   %% %%% %% %   %%.%% % % % % %%
% %   %     % % %   %   ...     % % %%
%   %  % %% %  %% % % % %%.%%% %%  %%%
% % % % % % % %       % % ..% % % % %%
% %   %      % % % %%     %.....% %%%%
%   %   % % %   %   % % % % % %.....%%
%%% %% % %    %   %  % %  %% % %%%%.%%
% %       % %   % % %   % %       %.%%
% % % % %    % %% % % %  % %% % %  .%%
%         % %   %       %     %   %P%%
%%%%%%%%%%%%%%%%%%%%%%%%%%%%%%%%%%%%%%
