%%%%%%%%%%%%%%%%%%%%%%%%%%%%%%%%%%%%%
%   %   % % %   % %   % %         % %
%% % % %% % % % %  % %   % %% % %   %
% %           %   %   % %         % %
%% % %% %% % % % %  %    % % % %% %%%
%       %   %     % % % % %     %   %
% % % %% %% % % % % %% %  % % %%  % %
% %   %     % %         %     % %   %
%  % %% % %  % % %%%% %   %% %  %% %%
% % %       % %         %     %     %
%% % %% % % % % % %% %%% % % % % %% %
% %   % %         %         %   %   %
% % %    % % % %%  % %% %% %% %   % %
%     % %       % %             % % %
% % %% % %% % %   % %% % % % % %%%% %
%   %   % % % % %   % % %           %
% %  %%  %%       %    % % %%% %%% %%
%   %   %   % % %   % %   %         %
% %  % % %%   % % %%% % %% % % %% % %
% % %       % %   %     %     % % % %
% %% % % % %%  %%  %% % %% % % %    %
% %       % % %   %   %         % % %
%%  % %%%    %%% %% %  %%% %%% %%   %
% %...    % %   % %   %           % %
% %.%.% %% %% % %   % % %% % % %% %%%
%  .%....     %   % %   %       %   %
%%%. % %.%% %...% % % %%  % % %   %%%
% %.% % ... ..%.  %   % % %     %   %
%% .   %%%.%.% .%   %   %   %% % % %%
% %.% %   ... %.  %   %   %         %
% %. %  % %% % .% % %%%%% % % %% %%%%
% ..% %   %   %.  %   % %   %     % %
%%.% %  %  % % .%...%     % % % %   %
% ..% %   %   %...%.% % %...%  ...% %
%%%.   % % %% %% % .% %%%.%...%.%...%
%...% % %     %   %.......% %...% %P%
%%%%%%%%%%%%%%%%%%%%%%%%%%%%%%%%%%%%%
