%%%%%%%%%%%%%%%%%%%%%%%%%%%%%%%%%%%%%
%   %   % % %   % %   % %         % %
%% % % %% % % % %  % %   % %% % %   %
% %           %   %   % %         % %
%% % %% %% % % % %  %    % % % %% %%%
%       %   %     % % % % %     %   %
% % % %% %% % % % % %% %  % % %%  % %
% %   %     % %         %     % %   %
%  % %% % %  % % %%%% %   %% %  %% %%
% % %       % %         %     %     %
%% % %% % % % % % %% %%% % % % % %% %
% %   % %         %         %   %   %
% % %    % % % %%  % %% %% %% %   % %
%     % %       % %             % % %
% % %% % %% % %   % %% % % % % %%%% %
%   %   % % % % %   % % %           %
% %  %%  %%       %    % % %%% %%% %%
%   %   %   % % %   % %   %         %
% %  % % %%   % % %%% % %% % % %% % %
% % %       % %   %     %     % % % %
% %% % % % %%  %%  %% % %% % % %    %
% %       % % %   %   %         % % %
%%  % %%%    %%% %% %  %%% %%% %%   %
% %...    % %   % %   %           % %
% %.%.% %% %% % %   % % %% % % %% %%%
%  .%.........%   % %   %       %   %
%%%. % % %% %...% % % %%  % % %   %%%
% %.% %       %...%   % % %     %   %
%% .   %%% % %  %...%   %   %% % % %%
% %.% %       %   %.  %   %         %
% %. %  % %% %  % %.%%%%% % % %% %%%%
% ..% %   %   %   %...% %   %     % %
%%.% %  %  % %  %   %.....% % % %   %
% ..% %   %   %   % % % %...%.....% %
%%%.   % % %% %% %  % %%% %...% %...%
%...% % %     %   %       % %   % %P%
%%%%%%%%%%%%%%%%%%%%%%%%%%%%%%%%%%%%%
