%%%%%%%%%%%%%%%%%%%%%%%
%.%   %   %   %   % % %
%.  %   %% % %%%% %%  %
%.%   % % % %       % %
%.%% %%%     %% %% %%%%
%.% %   % % % % %     %
%.%%% % %%%  %    %% %%
%.% %.....  % % %   % %
%.....% %.%%%   % %   %
% % % %  ...% % %   % %
%   %%% %%%.% %   % %%%
% %     % %.....%     %
%% % %%    %%%%.% %% %%
% % %   % %    ...  % %
%   %% %% %% %%%%.%%  %
% % %     %     %.% % %
%%%% %% %%  %% % . % %%
% % %     %   % %.% % %
% %% % %%%%% %   ...  %
% %       %   % % %.% %
%   %% %% %%% %   %.%%%
% % %   %       % %..P%
%%%%%%%%%%%%%%%%%%%%%%%
