%%%%%%%%%%%%%%%%%%%%%%%
%.%   %   %   %   % % %
%.  %   %% % %%%% %%  %
%.%   % % % %       % %
%.%% %%%     %% %% %%%%
%.% %...% % % % %     %
%.%%%.%.%%%  % ...%% %%
%.% %. ...  % %.%.  % %
%.....% %.%%%...%.%   %
% % % %  ...%.% %.  % %
%   %%% %%%.%.%  .% %%%
% %     % %...  %.    %
%% % %%    %%%% %.%% %%
% % %   % %      .  % %
%   %% %% %% %%%%.%%  %
% % %     %     %.% % %
%%%% %% %%  %% % . % %%
% % %     %   % %.% % %
% %% % %%%%% %   ...  %
% %       %   % % %.% %
%   %% %% %%% %   %.%%%
% % %   %       % %..P%
%%%%%%%%%%%%%%%%%%%%%%%
