%%%%%%%%%%%%%%%%%%%%%%%%%%%%%%%%%%%%%
%                                   %
%                                   %
%                                   %
%          %%%%%%%%%%%%%%%%%%%%%    %
%          %     ............  %    %
%          %     .%%%%%%%%%%.  %    %
%          %     .%        %.  %    %
%          %     .%        %.  %    %
%          %    ..%        %.  %    %
%          %   .. %   ....P%.  %    %
%          %  ..  %   .%%%%%.  %    %
%          % ..   %   .......  %    %
%          %..    %            %    %
%       .....     %            %    %
%      ..         %%%%%%%%%%%%%%    %
%      .                            %
%      .                            %
%     ..                            %
%%%%%%%%%%%%%%%%%%%%%%%%%%%%%%%%%%%%%
