%%%%%%%%%%%%%%%%%%%%%%%%%%%%%%%%%%%%%
%                                   %
%                                   %
%                                   %
%          %%%%%%%%%%%%%%%%%%%%%    %
%          %     ............  %    %
%          %     .%%%%%%%%%%.  %    %
%          %     .%        %.  %    %
%          %     .%        %.  %    %
%          %     .%        %.  %    %
%          %     .%   ....P%.  %    %
%          %     .%   .%%%%%.  %    %
%          %     .%   .......  %    %
%          %     .%            %    %
%                .%            %    %
%                .%%%%%%%%%%%%%%    %
%                .                  %
%                .                  %
%     ............                  %
%%%%%%%%%%%%%%%%%%%%%%%%%%%%%%%%%%%%%
